Gg, Gs^Fp, Gg, Hh, Hh, Hh, Hh, Hh, Hh, Gs^Fp, Gs^Fp, Gs^Fp, Gs^Fp, Gs^Fp, Gg, Gg, Gg, Gg, Rr, Rr, Gg, Rr, Rr, Aa, Aa, Aa, Ha, Ha, Hh, Mm, Mm, Mm, Mm, Hh, Hh, Gg, Gg, Gg, Gg, Gg, Gg, Aa
Gg, Gg, Gg, Gg, Gg, Gg, Hh, Gg, Gs^Fp, Gs^Fp, Gs^Fp, Gs^Fp, Gs^Fp, Gs^Fp, Gg, Gg, Rr, Rr, Gg, Gg, Gs^Fp, Hh, Hh, Aa, Aa, Aa, Aa, Aa, Gg, Hh, Hh, Mm, Mm, Hh, Hh, Gg, Gg, Gg, Gg, Gg, Aa, Aa
Rr, Gg, Rr, Gg, Gg, Gg, Gg, Gg, Gs^Fp, Gs^Fp, Gs^Fp, Gs^Fp, Gs^Fp, Gs^Fp, Rr, Rr, Gg, Gg, Gg, Hh, Hh, Hh, Hh, Ha, Aa, Aa, Aa, Aa, Gg, Gg, Gg, Hh, Hh, Hh, Gg, Gg, Gg, Gg, Gg, Gg, Gg, Gg
Gg, Rr, Gg, Rr, Rr, Gg, Gg, Gg, Gg, Gs^Fp, Gs^Fp, Gg, Rr, Rr, Gs^Fp, Gg, Gg, Gg, Gs^Fp, Hh, Hh, Hh, Hh, Hh, Aa, Aa, Aa, Aa, Rr, Gg, Gg, Gg, Rr, Rr, Rr, Rr, Rr, Aa, Aa, Gg, Gg, Gg
Gg, Gg, Gg, Gg, Rr, Gg, Rr, Gg, Rr, Gs^Fp, Rr, Gs^Fp, Rr, Gs^Fp, Gs^Fp, Gg, Gs^Fp, Gs^Fp, Gs^Fp, Gs^Fp, Gs^Fp, 1 Kh, Gg, Gg, Gg, Gg, Aa, Rr, Gg, Rr, Rr, Rr, Gg, Gg, Gg, Aa, Aa, Aa, Aa, Gg, Gg, Gg
Gg, Gg, Gg, Gg, Gg, Rr, Gg, Rr, Gg, Rr, Gg, Rr, Gs^Fp, Gs^Fp, Gg, Gg, Gs^Fp, Gs^Fp, Gg, Gs^Fp, Gs^Fp, Rr^Cov, Gs^Fp, Gs^Fp, Gs^Fp, Gg, Gg, Gg, Gg, Gg, Aa, Aa, Aa, Aa, Aa, Aa, Aa, Aa, Aa, Rr, Rr, Gg
Gg, Gg, Gg, Gg, Gg, Gg, Aa, Gg, Gg, Gg, Gg, Ds, Gs^Fp, Gs^Fp, Gs^Fp, Gs^Fp, Gs^Fp, Gs^Fp, Gs^Fp, Gs^Fp, Gs^Fp, Rr, Gs^Fp, Gs^Fp, Gs^Fp, Gg, Gg, Gg, Gg, Aa, Aa, Aa, Gg, Aa, Aa, Aa, Aa, Aa, Aa, Gg, Gg, Rr
Aa, Aa, Aa, Aa, Gg, Gg, Aa, Gg, Gg, Gg, Ds, Ds, Ds, Gs^Fp, Gs^Fp, Gg, Gg, Gs^Fp, Gs^Fp, Gs^Fp, Gs^Fp, Rr, Gs^Fp, Gs^Fp, Gs^Fp, Gg, Gg, Gg, Aa, Aa, Aa, Aa, Aa, Aa, Aa, Aa, Aa, Aa, Aa, Aa, Gg, Gg
Aa, Aa, Aa, Aa, Gg, Gg, Gg, Gg, Gg, Gg, Gg, Gg, Gg, Gs^Fp, Gg, Gg, Gg, Gs^Fp, Gs^Fp, Gg, Gs^Fp, Rr, Gs^Fp, Gs^Fp, Gs^Fp, Gg, Gg, Gg, Gg, Aa, Aa, Aa, Aa, Aa, Aa, Aa, Aa, Aa, Ha, Ha, Ha, Ha
Aa, Gg, Gg, Gg, Gg, Gg, Gg, Gg, Gg, Gg, Ds, Gg, Gg, Gg, Gg, Gg, Gg, Gg, Ds, Ds, Gs^Fp, Rr, Gs^Fp, Gs^Fp, Gs^Fp, Gs^Fp, Gg, Gg, Gg, Gg, Gg, Aa, Aa, Gg, Aa, Aa, Hh, Hh, Hh, Mm, Mm, Rr
Gg, Gg, Gg, Gs^Fp, Gs^Fp, Gg, Gg, Gg, Gg, Aa, Aa, Gg, Gg, Aa, Aa, Gg, Gg, Gs^Fp, Ds, Gg, Gg, Rr, Gg, Gs^Fp, Gs^Fp, Gg, Gg, Gg, Gg, Gg, Gg, Gg, Aa, Aa, Aa, Ha, Hh, Mm, Mm, Mm, Mm, Rr
Gg, Gs^Fp, Gs^Fp, Gs^Fp, Gs^Fp, Gg, Gg, Aa, Gg, Aa, Aa, Gg, Aa, Gg, Gg, Gg, Gg, Gg, Gg, Gg, Gg, Rr, Gg, Gg, Gg, Gg, Gg, Gg, Gs^Fp, Gs^Fp, Gs^Fp, Gg, Aa, Aa, Aa, Ha, Mm, Mm, Mm, Mm, Mm, Mm
Gs^Fp, Gs^Fp, Gs^Fp, Gs^Fp, Gs^Fp, Gg, Gg, Gg, Gg, Gg, Gg, Aa, Aa, Gg, Gg, Gg, Gg, Gg, Gg, Gg, Rr, Rr, Gg, Gg, Gg, Gg, Gg, Gg, Gs^Fp, Gs^Fp, Gs^Fp, Gg, Gg, Aa, Aa, Hh, Hh, Mm, Mm, Mm, Mm, Mm
Gs^Fp, Gg, Gg, Gs^Fp, Gs^Fp, Gg, Gg, Gg, Gg, Gg, Gg, Gg, Gg, Gg, Gg, Gg, Gg, Gg, Gg, Rr, Gg, Gg, Gg, Gg, Gg, Gg, Gg, Gg, Gs^Fp, Gs^Fp, Gs^Fp, Gg, Gg, Aa, Aa, Hh, Hh, Mm, Mm, Mm, Hh, Hh
Gs^Fp, Gg, Hh, Gs^Fp, Gg, Gg, Gg, Gg, Gg, Gg, Gg, Gs^Fp, Gg, Gg, Gg, Gg, Gg, Gg, Gg, Aa, Aa, Aa, Gg, Gg, Gg, Gg, Gg, Gg, Gs^Fp, Gs^Fp, Gs^Fp, Gs^Fp, Gg, Aa, Aa, Gg, Hh, Mm, Hh, Hh, Hh, Aa
Hh, Hh, Hh, Gg, Gg, Gg, Gg, Gg, Gg, Gg, Gg, Gg, Gs^Fp, Gg, Gg, Gg, Gg, Gg, Gg, Rr, Aa, Aa, Aa, Aa, Aa, Gg, Gg, Gs^Fp, Gs^Fp, Gs^Fp, Gs^Fp, Gs^Fp, Gg, Gg, Gg, Aa, Hh, Mm, Hh, Ha, Aa, Aa
Hh, Hh, Hh, Gg, Gg, Gg, Gg, Gg, Gg, Gg, Gg, Gg, Gg, Gs^Fp, Gs^Fp, Gs^Fp, Gs^Fp, Gg, Gg, Rr, Aa, Aa, Gg, Gg, Gg, Gg, Gg, Gs^Fp, Gs^Fp, Gs^Fp, Gs^Fp, Ss, Gs^Fp, Gg, Gg, Gg, Hh, Hh, Ha, Ha, Aa, Aa
Gs^Fp, Gs^Fp, Gg, Gg, Gg, Gs^Fp, Gs^Fp, Gs^Fp, Gg, Gg, Gg, Gg, Gg, Gs^Fp, Gs^Fp, Gs^Fp, Gs^Fp, Gs^Fp, Gg, Rr, Aa, Hh, Hh, Gg, Gg, Gg, Gg, Gs^Fp, Gs^Fp, Gs^Fp, Gs^Fp, Gs^Fp, Gs^Fp, Gg, Gg, Gg, Hh, Mm, Mm, Ha, Aa, Aa
Gs^Fp, Gs^Fp, Gg, Gg, Gs^Fp, Gs^Fp, Gs^Fp, Gs^Fp, Gg, Gg, Gg, Gg, Gg, Gs^Fp, Gs^Fp, Gs^Fp, Gs^Fp, Gg, Gg, Rr, Rr, Hh, Hh, Hh, Gg, Gg, Gs^Fp, Gs^Fp, Gs^Fp, Gs^Fp, Gs^Fp, Ds, Gs^Fp, Gg, Gg, Gg, Hh, Hh, Mm, Ha, Aa, Aa
Gg, Gg, Gg, Gs^Fp, Gs^Fp, Gs^Fp, Gs^Fp, Gs^Fp, Gg, Gg, Gg, Gg, Gg, Gg, Gg, Gs^Fp, Gg, Gg, Gg, Gg, Rr, Gg, Gg, Gg, Gs^Fp, Gs^Fp, Gs^Fp, Gs^Fp, Gs^Fp, Gs^Fp, Gg, Gg, Gg, Gg, Gg, Gg, Ha, Mm, Hh, Ha, Aa, Aa
Aa, Gg, Gg, Gs^Fp, Gs^Fp, Gs^Fp, Gg, Gg, Gg, Gg, Gg, Gg, Gg, Gg, Gg, Gg, Gg, Gg, Gg, Gg, Rr, Gg, Gg, Gg, Gs^Fp, Gs^Fp, Gs^Fp, Gs^Fp, Gs^Fp, Gg, Gg, Gg, Gg, Gg, Gg, Gg, Aa, Hh, Hh, Aa, Aa, Aa
Aa, Gg, Gg, Gg, Gs^Fp, Gs^Fp, Gg, Gg, Gg, Gg, Gg, Gg, Gg, Aa, Aa, Aa, Aa, Aa, Gg, Gg, Rr, Gg, Gg, Gg, Gs^Fp, Gs^Fp, Gs^Fp, Gs^Fp, Gs^Fp, Gg, Gg, Aa, Aa, Aa, Aa, Gg, Gg, Gg, Gg, Aa, Aa, Aa
Aa, Gg, Gg, Gg, Gg, Gg, Gg, Gg, Gg, Gg, Gg, Gg, Aa, Aa, Ha, Gg, Gg, Gg, Gg, Rr, Gg, Gg, Gg, Gg, Gs^Fp, Gs^Fp, Gs^Fp, Gs^Fp, Gs^Fp, Gg, Gg, Aa, Aa, Gg, Gg, Gg, Gg, Gg, Gg, Aa, Aa, Aa
Gg, Aa, Aa, Gg, Gg, Gg, Aa, Gg, Gg, Gg, Gg, Hh, Aa, Aa, Gg, Gg, Gg, Gg, Rr, Rr, Gg, Gg, Gg, Gg, Gg, Gs^Fp, Gs^Fp, Gs^Fp, Gs^Fp, Gg, Gg, Aa, Aa, Gg, Gg, Gg, Gg, Gg, Gg, Gg, Aa, Aa
Gg, Aa, Aa, Gg, Gg, Gg, Gg, Gg, Gg, Gg, Hh, Gg, Aa, Aa, Gg, Gg, Hh, Gg, Rr, Gg, Gg, Gg, Gg, Gg, Gg, Gs^Fp, Gs^Fp, Gs^Fp, Gs^Fp, Gg, Gg, Aa, Gg, Gg, Gg, Gg, Gg, Aa, Gg, Aa, Aa, Aa
Gg, Aa, Aa, Aa, Aa, Aa, Gg, Gg, Gg, Gg, Gg, Gg, Aa, Gg, Gg, Gs^Fp, Rr, Rr, Gg, Gg, Gg, Gg, Gs^Fp, Gg, Gg, Gs^Fp, Gs^Fp, Gs^Fp, Gs^Fp, Gs^Fp, Gg, Gg, Aa, Aa, Aa, Aa, Aa, Aa, Aa, Aa, Aa, Aa
Gg, Aa, Aa, Aa, Aa, Aa, Aa, Gg, Gg, Gs^Fp, Gs^Fp, Gg, Aa, Gg, Gs^Fp, Gs^Fp, Rr, Gg, Gg, Gg, Gg, Gg, Gg, Gg, Gg, Gs^Fp, Gs^Fp, Gs^Fp, Gs^Fp, Gg, Gg, Gg, Gg, Gg, Aa, Aa, Gg, Gg, Aa, Gg, Gg, Gg
Gg, Aa, Aa, Aa, Aa, Aa, Aa, Gg, Gs^Fp, Gs^Fp, Gs^Fp, Gs^Fp, Gg, Gg, Rr, Gg, Rr, Gs^Fp, Gg, Gg, Gg, Gg, Gg, Gg, Gg, Gg, Gs^Fp, Gs^Fp, Gg, Gg, Gg, Gg, Gg, Gg, Gg, Gg, Gg, Gg, Gg, Gg, Gg, Gg
Gg, Gg, Gg, Gg, Aa, Aa, Aa, Gg, Gg, Gs^Fp, Gs^Fp, Gs^Fp, Rr, Rr, Gg, Rr, Gg, Gg, Gg, Gg, Gg, Gg, Gg, Gg, Gg, Gs^Fp, Gg, Gg, Gs^Fp, Gs^Fp, Gg, Gg, Gg, Gg, Gg, Gg, Gg, Gg, Gg, Gs^Fp, Gs^Fp, Gg
Gg, Gg, Gg, Gg, Gg, Gg, Aa, Gg, Gg, Gs^Fp, Ss, Ss, Rr, Ds, Ds, Ds, Gg, Gg, Gg, Gg, Gg, Gg, Gg, Gg, Gg, Gg, Gg, Gg, Gg, Gs^Fp, Gs^Fp, Gs^Fp, Gs^Fp, Gg, Gg, Gg, Gg, Gg, Gs^Fp, Gs^Fp, Gs^Fp, Gg
Gg, Gg, Gg, Gg, Gg, Gg, Gg, Gg, Gg, Gs^Fp, Gs^Fp, Gs^Fp, Rr, Ds, Ds, Ds, Ds, Gg, Gg, Gg, Aa, Gg, Gg, Gg, Hh, Gg, Gg, Aa, Gg, Gs^Fp, Gs^Fp, Gs^Fp, Gs^Fp, Gs^Fp, Gg, Gg, Gs^Fp, Gs^Fp, Gs^Fp, Gs^Fp, Gs^Fp, Gg
Gg, Gg, Gs^Fp, Gs^Fp, Gs^Fp, Gs^Fp, Gs^Fp, Gg, Gg, Gg, Gg, Rr, Ds, Ww, Ww, Ww, Ds, Gg, Gg, Aa, Gg, Gg, Gg, Hh, Hh, Gg, Gg, Aa, Gg, Gs^Fp, Gs^Fp, Gs^Fp, Gs^Fp, Gs^Fp, Gs^Fp, Gs^Fp, Gs^Fp, Gs^Fp, Gs^Fp, Gs^Fp, Gg, Gg
Gg, Gg, Gs^Fp, Gs^Fp, Gg, Gg, Gg, Gs^Fp, Gg, Gg, Rr, Rr, Gs^Fp, Ds, Ds, Ww, Aa, Aa, Aa, Aa, Aa, Hh, Hh, Hh, Hh, Gg, Aa, Aa, Gg, Gg, Gs^Fp, Gs^Fp, Gs^Fp, Gs^Fp, Gs^Fp, Gg, Gg, Gg, Gs^Fp, Gs^Fp, Gg, Gg
Gg, Gg, Gs^Fp, Gs^Fp, Gg, Gg, Gg, Gs^Fp, Rr, Rr, Gg, Gg, Gs^Fp, Gs^Fp, Gg, Aa, Aa, Aa, Aa, Aa, Ha, Hh, Mm, Hh, Hh, Gg, Aa, Aa, Gg, Gg, Gg, Gs^Fp, Gs^Fp, Gg, Gg, Ss, Gg, Gg, Gg, Gg, Gs^Fp, Gg
Gg, Gg, Gs^Fp, Gg, Ch, Gg, Rr, Rr, Hh, Gg, Gg, Gg, Gg, Gg, Gg, Aa, Aa, Aa, Aa, Aa, Ha, Mm, Mm, Hh, Gg, Gg, Aa, Aa, Gg, Aa, Gg, Gs^Fp, Gs^Fp, Gg, Gg, Gg, Ds, Ds, Gg, Gg, Gs^Fp, Gg
Gs^Fp, Gs^Fp, Ch, Ch, Ch, Ch, Ch, Gs^Fp, Gs^Fp, Gg, Gg, Gg, Aa, Aa, Aa, Aa, Aa, Aa, Aa, Ha, Mm, Mm, Mm, Hh, Gg, Gg, Aa, Gg, Aa, Aa, Gg, Gg, Gs^Fp, Gg, Gg, Gg, Ds, Ds, Gg, Gg, Gs^Fp, Gg
Gs^Fp, Gs^Fp, Ch, Ch, 3 Kh, Ch, Ch, Hh, Gg, Gg, Gg, Aa, Aa, Aa, Aa, Aa, Aa, Aa, Aa, Ha, Mm, Mm, Mm, Hh, Gg, Gg, Aa, Aa, Aa, Aa, Gg, Gg, Gs^Fp, Gs^Fp, Ss, Ss, Ss, Gg, Gg, Gs^Fp, Gs^Fp, Gg
Gs^Fp, Gs^Fp, Ch, Ch, Ch, Ch, Ch, Hh, Gg, Gg, Aa, Aa, Aa, Aa, Aa, Aa, Aa, Aa, Ha, Ha, Mm, Mm, Hh, Hh, Aa, Aa, Aa, Aa, Aa, Aa, Gg, Gg, Gs^Fp, Gs^Fp, Ss, Ss, Ss, Gs^Fp, Gs^Fp, Gs^Fp, Gg, Gg
Gs^Fp, Gs^Fp, Gg, Ch, Ch, Ch, Hh, Hh, Gg, Gg, Aa, Aa, Aa, Gg, Gg, Gg, Aa, Aa, Aa, Ha, Mm, Mm, Hh, Gg, Aa, Aa, Gg, Gg, Gg, Gg, Gg, Gs^Fp, Gs^Fp, Gs^Fp, Gs^Fp, Gs^Fp, Gs^Fp, Gs^Fp, Gg, Gg, Gg, Gg
Gg, Gg, Gg, Gg, Gg, Gg, Gg, Gg, Gg, Gg, Aa, Aa, Aa, Gg, Gg, Gg, Aa, Aa, Aa, Ha, Mm, Mm, Hh, Hh, Gg, Gg, Gg, Gg, Gg, Gg, Gg, Gs^Fp, Gs^Fp, Ds, Gg, Gg, Gg, Gg, Aa, Gg, Gg, Gg
Gg, Gg, Gg, Gg, Gg, Gg, Gg, Gg, Gg, Gg, Aa, Aa, Aa, Gg, Gg, Gg, Aa, Aa, Aa, Gg, Hh, Hh, Hh, Hh, Hh, Gg, Gg, Gg, Gg, Gg, Gs^Fp, Gs^Fp, Gg, Gg, Gg, Aa, Aa, Aa, Aa, Aa, Gg, Gg
Gg, Gg, Gg, Gg, Gg, Gg, Gg, Gg, Gg, Gg, Aa, Aa, Aa, Aa, Aa, Aa, Aa, Aa, Aa, Gg, Gg, Hh, Hh, Hh, Gg, Gg, Gg, Gg, Gs^Fp, Gs^Fp, Gs^Fp, Gg, Gg, Gg, Gg, Gg, Aa, Aa, Aa, Aa, Aa, Gg
